var tilemaps = {

	"desert_1": 
	{
		"map": [
			"#########################", 
			"#                       #", 
			"#                       #", 
			"#                       #", 
			"#           P           #", 
			"#                       #", 
			"#                 0     #", 
			"#                  0    #", 
			"#                       #", 
			"#                       #", 
			"#      R         T      #", 
			"#                       #", 
			"#                       #", 
			"#      #      S         #", 
			"#      #          ##    #", 
			"#      #                #", 
			"#      #                #", 
			"#      #                #", 
			"#########################", 
		],
	},

	"desert_2": 
	{
		"map": [
			"#########################", 
			"#                       #", 
			"#                       #", 
			"#                       #", 
			"#                       #", 
			"#                       #", 
			"#           P           #", 
			"#                  #    #", 
			"#                       #", 
			"#     #                 #", 
			"#  R  #    B            #", 
			"#     #                 #", 
			"#     #                 #", 
			"##############          #", 
			"#            #          #", 
			"#      T                #", 
			"#                       #", 
			"#                       #", 
			"#########################", 
		],
	}
}