var tilemaps = {

	"Desert1": 
	{
		"map": [
			"#########################", 
			"#                       #", 
			"#                       #", 
			"#           1           #", 
			"#                       #", 
			"#    #             #    #", 
			"#                  #    #", 
			"#                       #", 
			"#                       #", 
			"#      +         $      #", 
			"#                       #", 
			"#                       #", 
			"#      #      @         #", 
			"#      #          ##    #", 
			"#      #                #", 
			"#      #                #", 
			"#########################", 
		],
	},

	"Desert2": 
	{
		"map": [
			"#########################", 
			"#                       #", 
			"#                       #", 
			"#                       #", 
			"#                       #", 
			"#                       #", 
			"#                  1    #", 
			"#                       #", 
			"#     #                 #", 
			"#  +  #    B            #", 
			"#     #                 #", 
			"#     #                 #", 
			"##############          #", 
			"#            #          #", 
			"#      $                #", 
			"#                       #", 
			"#########################", 
		],
	}
}