var tilemaps = {

	"desert_1": 
	{
		"map": [
			"#########################", 
			"#                       #", 
			"#                       #", 
			"#                       #", 
			"#           P           #", 
			"#                       #", 
			"#                 0     #", 
			"#                  0    #", 
			"#                       #", 
			"#                       #", 
			"#      R         T      #", 
			"#                       #", 
			"#                       #", 
			"#      #      S         #", 
			"#      #          ##    #", 
			"#      #                #", 
			"#      #                #", 
			"#      #                #", 
			"#########################", 
		],
	},

	"desert_2": 
	{
		"map": [
			"#########################", 
			"#                       #", 
			"#                       #", 
			"#                       #", 
			"#      R         R      #", 
			"#                       #", 
			"#        ##   ##        #", 
			"#        #     #        #", 
			"#                       #", 
			"#           P           #", 
			"#                       #", 
			"#        #     #        #", 
			"#        ##   ##        #", 
			"#                       #", 
			"#      R         R      #", 
			"#                       #", 
			"#     B                 #", 
			"#                       #", 
			"#########################", 
		],
	},

	"desert_3": 
	{
		"map": [
			"#########################", 
			"#                       #", 
			"#                       #", 
			"#                       #", 
			"#                       #", 
			"#                       #", 
			"#                       #", 
			"#                       #", 
			"#                       #", 
			"#           P           #", 
			"#                       #", 
			"#                       #", 
			"#                       #", 
			"#                       #", 
			"#                       #", 
			"#                       #", 
			"#                       #", 
			"#                       #", 
			"#########################", 
		],
	}
}